0,0,0,0,0,0,0,0,0,0,0,0,0,0,0,0,0,0,0,0,0,0,0,0,0,0,0,0,0,0,0,0,0,0,0,0,0,0,0,0,0,0,0,0,4,0,0,0,0,0,0,0,0,0,0,0,0,5
6,0,0,0,0,0,0,0,0,0,0,0,0,0,0,0,0,0,0,0,0,0,0,0,0,0,0,0,0,0,0,0,0,0,0,0,0,0,0,0,0,0,0,0,4,0,0,0,0,0,0,0,0,0,0,0,0,5
6,0,0,0,0,0,0,0,0,0,0,0,0,0,0,0,0,0,0,0,0,0,0,0,0,0,0,0,0,0,0,0,0,0,0,9,0,0,0,0,0,0,0,0,4,0,0,0,E,F,0,0,4,0,0,0,0,5
6,0,0,0,0,0,0,0,0,0,0,0,0,0,0,0,0,0,0,0,0,0,0,0,0,0,0,0,0,0,0,0,0,0,3,4,5,6,7,3,0,0,0,0,4,4,4,4,4,4,4,4,4,0,0,0,0,5
6,0,0,0,0,0,0,0,0,0,0,0,0,0,0,0,0,0,0,0,0,0,0,0,0,0,0,0,0,0,0,0,0,0,3,0,0,0,2,3,3,0,0,0,0,4,4,4,4,4,4,4,4,4,0,0,0,5
6,0,0,0,0,0,0,0,0,0,0,0,0,0,0,0,0,0,0,0,0,0,0,0,0,0,0,0,0,0,0,0,0,0,3,0,0,0,2,3,3,3,0,0,0,0,0,0,0,0,0,0,0,0,0,0,0,5
6,0,0,0,0,0,0,9,0,0,0,0,0,0,0,0,0,0,0,0,0,0,0,0,0,0,0,0,F,0,0,4,4,4,4,0,0,0,2,3,3,3,3,0,0,0,0,0,0,0,0,0,0,0,0,0,3,5
6,0,0,0,0,0,7,7,0,0,F,0,2,2,0,0,0,0,0,9,0,0,0,0,3,3,2,5,5,5,5,5,5,5,5,0,0,0,2,3,3,3,3,3,0,0,0,0,0,0,0,0,0,0,0,0,0,5
6,0,0,0,0,0,7,7,0,0,1,1,2,2,0,0,F,0,2,2,2,2,0,2,2,2,2,2,2,2,2,2,2,2,2,0,0,0,2,3,3,3,3,3,3,0,F,0,0,0,0,F,0,0,F,0,0,5
1,1,1,1,1,1,1,1,1,1,1,1,1,1,1,1,1,1,1,1,1,1,1,1,1,1,1,1,1,1,1,1,1,1,1,0,0,0,2,2,2,2,2,2,2,2,2,2,2,2,2,2,2,2,2,2,2,2
